Thank you	ğŸ˜Š
Thanks	ğŸ˜Š
Enjoy	ğŸ˜‰
Awesome	ğŸ‘Œ
Super	ğŸ‘Œ
Perfect	ğŸ‘Œ
Happy	ğŸ˜Š
lol	ğŸ˜‚
rofl	ğŸ¤£
Good morning	ğŸ™
Good evening	ğŸ™
Good night	ğŸ˜´
Welcome	ğŸ™
Sure	ğŸ‘
Sure thing	ğŸ‘
No problem	ğŸ˜Š
No problems	ğŸ˜Š
Cancelled	ğŸ˜
Happy new year	ğŸ‰
happy married life	ğŸ‰
happy rose day	ğŸ‰
happy valentine's day	ğŸ‰
All these are	NP
Merry christmas	ğŸ…
it's not working	ğŸ˜¢
feeling hungry	ğŸ˜‹
love you	ğŸ˜
happy birthday	ğŸ‚
happy marriage anniversary	ğŸ‰
thank you guys	ğŸ˜Š
anytime	ğŸ˜Š
thanks for your time	ğŸ™
have a good day	ğŸ˜Š
Hi there	ğŸ˜Š
boring	ğŸ˜´
that looks wow	ğŸ˜
it looks nice	ğŸ‘Œ
lovely pics	ğŸ˜
fine	ğŸ™‚
bon voyage	ğŸ›«
romantic dinner	ğŸ˜
wonderful	ğŸ‘
worth it	ğŸ‘Œ
good job	ğŸ‘
working	ğŸ’ª
not working	ğŸ˜•
nice click	ğŸ‘
RIP	ğŸ™
lmao	ğŸ¤£
hello	ğŸ‘‹
hi	ğŸ‘‹
hey	ğŸ‘‹
blushing	ğŸ˜Š
I'm confused	ğŸ¤·
take care	ğŸ™‚
happy anniversary	ğŸ‰
I	NP
We	NP
exactly	ğŸ’¯
congrats	ğŸ‘
Done	âœ…
congratulations	ğŸ‘
beautiful	ğŸ˜
right	âœ…
okay	ğŸ‘Œ
nice	ğŸ‘Œ
amen	ğŸ™
what	ğŸ˜³
agreed	ğŸ‘
cute	ğŸ˜
amazing	ğŸ‘
absolutely	ğŸ’¯
good	ğŸ‘
sure	ğŸ‘
definitely	ğŸ‘
gorgeous	ğŸ˜
brilliant	ğŸ‘
wow	ğŸ‘
agree	ğŸ‘
great	ğŸ‘
cutie	ğŸ’“
Good luck	ğŸ‘
oops	ğŸ˜¬
yikes	ğŸ˜¬
maybe	ğŸ‘€
lovely	ğŸ˜
omg	ğŸ˜³
legend	ğŸ™Œ
sigh	ğŸ˜•
pretty	ğŸ˜
stunning	ğŸ˜
respect	ğŸ™Œ
noted	âœ…
woah	ğŸ˜³
blessed	ğŸ™Œ
fantastic	ğŸ‘
you're welcome	ğŸ˜Š
you are welcome	ğŸ˜Š
love it	ğŸ˜€
yes please	ğŸ™
love this	ğŸ˜€
true	ğŸ‘
i agree	ğŸ‘
Oh no	ğŸ˜¢
well said	ğŸ‘
sorry	ğŸ˜
miss you	ğŸ˜˜
well done	ğŸ‘
have fun	ğŸ‘
can't sleep	ğŸ˜•
thanks love	ğŸ˜˜
hell yeah	ğŸ˜
the best	ğŸ‘Œ
welcome back	ğŸ™
my pleasure	ğŸ˜Š
oh yeah	ğŸ˜
why not	ğŸ¤·
so sad	ğŸ˜
no worries	ğŸ‘
wait what	ğŸ˜³
i'm ready	ğŸ’ª
my man	ğŸ’ª
good one	ğŸ‘
oh dear	ğŸ˜³
my love	ğŸ’“
good afternoon	ğŸ˜Š
nice one	ğŸ‘
stay strong	ğŸ’ª
well deserved	ğŸ‘
love you too	ğŸ˜˜
oh my god	ğŸ˜³
proud of you	ğŸ‘
thanks so much	ğŸ™
get well soon	ğŸ˜Š
miss you too	ğŸ˜˜
thank you baby	ğŸ˜˜
thank you babe	ğŸ˜˜
got this	ğŸ‘
got it	ğŸ‘
i got you	ğŸ˜‰
you know it	ğŸ˜œ
love you more	ğŸ˜˜
thanks for sharing	ğŸ‘
see you there	ğŸ‘
i like it	ğŸ‘Œ
see you soon	ğŸ˜Š
you deserve it	ğŸ‘
excited	ğŸ˜†
hate you	ğŸ˜‘
you go girl	ğŸƒâ€â™€
good for you	ğŸ‘
all the best	ğŸ‘
i don't know	ğŸ˜•
i see you	ğŸ‘€
thanks a lot	ğŸ™
i feel attacked	ğŸ˜
i'll be there	ğŸ‘
thank you gorgeous	ğŸ˜˜
cool	ğŸ˜
Lipstick	NP
fever	ğŸ¤’
heart	â¤
man	ğŸ‘¨
woman	ğŸ‘©
teddy bear	â¤
bath	ğŸ›
sunny	ğŸŒ
selfie	ğŸ¤³
surprised	ğŸ˜®
loving	â¤
ha ha	ğŸ˜‚
he he	ğŸ˜‚
don't make noise	ğŸ¤«
disheartening	ğŸ˜”
i am here	âœ‹
use your brain	ğŸ¤”
fingers crossed	ğŸ¤
black heart	ğŸ–¤
green apple	ğŸ
when	ğŸ¤”
where	ğŸ¤”
how	ğŸ¤”
ghost	ğŸ‘»
Thumbs down	ğŸ‘
crossed fingers	ğŸ¤
traffic light	ğŸš¥
song	ğŸµ
King	ğŸ¤´
Queen	ğŸ‘¸
demon	ğŸ˜ˆ
smart	ğŸ¤“
party	ğŸ¥³
Cold	ğŸ¥¶
turn right	â¡ï¸
turn left	â¬…ï¸
happiness	ğŸ˜Š
ohh please	ğŸ˜
safety pin	ğŸ§·
photo frame	ğŸ–¼
alright	ğŸ‘
mermaid	ğŸ§œâ€â™€ï¸
evil	ğŸ˜ˆ
gold medal	ğŸ…
silver medal	ğŸ¥ˆ
bronze medal	ğŸ¥‰
martial art	ğŸ¥‹
martial arts	ğŸ¥‹
hearts	ğŸ’•
united kingdom	ğŸ‡¬ğŸ‡§
united states	ğŸ‡ºğŸ‡¸
united states of america	ğŸ‡ºğŸ‡¸
evil smile	ğŸ˜ˆ
christmas tree	ğŸ„
right turn	â¡ï¸
left turn	â¬…ï¸
sparkling heart	ğŸ’–
happy brother day	ğŸ’™
happy brother's day	ğŸ’™
hot dog	ğŸŒ­
he is bald	ğŸ‘¨â€ğŸ¦²
she is bald	ğŸ‘©â€ğŸ¦²
graduated	ğŸ“
i don't like	ğŸ˜
envelope	âœ‰
no smoking	ğŸš­
stop lying	ğŸ¤¥
pregnant	ğŸ¤°
feeding her baby	ğŸ¤±
clown	ğŸ¤¡
study	ğŸ“–
mind blowing	ğŸ¤¯
get lost	ğŸ˜
shopping cart	ğŸ›’
no littering	ğŸš¯
no pedestrians	ğŸš·
have a nice day	ğŸ˜Š
don't think so	ğŸ¤”
me too	âœ‹
thank you very much	ğŸ˜Š
like each other	ğŸ˜
won	ğŸ†
tired	ğŸ˜«